................................
................................
................................
........##############..........
........#............#..........
........#............#..........
........#......#######..........
S########......#................
...............#................
...............#................
...............#................
...............#................
...............#................
...............#................
...............################E
................................
................................
................................
................................
................................
................................
................................
................................
................................