################################
#..............................#
#..............................#
#...........~~~~~~~~...........#
#.......~~~~~~~~~~~~~..........#
#..........~~~~~~~~~...........#
#..............~~~.............#
#..............................#
#.......&.............&&.......#
#..............................#
#..............................#
#..............................#
#..............................#
#..........#####...............#
#............##........%.......#
#..............................#
#..............................#
#.........%&&.........&%.......#
#.........##...................#
#.....#########................#
#........#####.................#
#..................#%..........#
#..............................#
################################